OXXXBXXXXXOOOVO
EXXGGXXGXXOXBXX
OBXGGXXGXXOXXXX
OXXGGBXGBXOXGGG
OXXGGXXGXXOXGGG
OOXGGXXGXXOXGGG
XOXXXXBXBXOXXXX
XOOOOXXXXXOXXXX
GXXXOXXOXXOXXXG
GGXXOOSOOTOXXGG