OOBGGGGBGGGGBEE
GOXXGGGGGGGXXOG
GVOOXGGGGGXOOOG
GXXOXXGGGXXOXXG
XXXOOOXGXOOOXXX
XXBXXOXBXOXXBXX
XXGXXOGGGOXXGXX
XGGGXOOOOOXGGGX
GGGGGXGOGXGGGGG
GGGGGSTOGXGGGGG