OOBGGGGBGGGGBOO
GOXXGGGGGGGXXOG
GOOOXGGGGGXOOOG
GXXOXXGGGXXOXXG
XXXOOOXGXOOOXXX
XXBXXOXBXOXXBXX
XXGXXOGGGOXXGXX
XGGGXOOOOOXGGGX
GGGGGXGOGXGGGGG
GGGGGSTOGXGGGGG