OXXXBXXXXXOOOOO
OXXGGXXGXXOXBXX
OBXGGXXGXXOXXXX
OXXGGBXGBXOXGGG
OXXGGXXGXXOXGGG
OOXGGXXGXXOXGGG
XOXXXXBXBXOXXXX
XOOOOXXXXXOXXXX
GXXXOXXSXXOXXXG
GGXXOOOOOOOXXGG