OEOOOOOVOOOOOEO
OBGGGGBOGGGGGGO
OGGGGGGOXGGBGXO
OXGGGGXOGGBGGGO
EGGGGGGOXGGGGXE
OXGGGGXOBGGGGGO
OGGBGGGOXGGGGXO
OXGGBGXOGGGGGGO
OGGGGGGOGGGGGGO
OOOOTOOSOOOOOOO