OOOOOOOOOOOOOOO
OBGGGGBOGGGGGGO
OGGGGGGOXGGBGXO
OXGGGGXOGGBGGGO
OGGGGGGOXGGGGXO
OXGGGGXOBGGGGGO
OGGBGGGOXGGGGXO
OXGGBGXOGGGGGGO
OGGGGGGOGGGGGGO
OOOOTOOSOOOOOOO