OXXXBXXXXXOOOEO
OXXGGXXGXXOXBXX
OBXGGXXGXXOXXXX
OXXGGBXGBXOXGGG
OXXGGXXGXXOXGGG
OOXGGXXGXXOXGGG
XOXXXXBXBXOXXXX
XOOOOXXXXXOXXXX
GXXXOXXOXXOXXXG
GGXXOOSOOTOXXGG